1111111111111
100PC0000C0C1
1000011111001
100011E000011
1111111111111
